10
0 15 0 0 0 3 0 0
0 20 0 0 0 4 0 0
0 0 0 0 0 0 0 25
1 0 0 0 0 10 0 0
0 0 15 0 0 15 0 4
0 0 20 0 0 20 0 10
1 0 0 0 0 0 0 25
2 0 0 0 0 25 0 0
4 0 0 0 0 5 0 0
0 0 0 0 0 0 1 0
