7
0 10 1 0 0 0 0 0
0 10 10 0 0 0 0 0
0 0 0 0 0 0 0 15
1 0 25 0 0 0 0 0
0 5 10 0 0 0 0 10
0 0 0 0 0 0 0 30
2 0 10 0 0 0 0 0
