0 1
6 6 14 6 15 6 6 15 6 11 11 11 11 11 11 11 11 6 7 7
22 2 2 2 2 2 2 6 6 11 6 6 11 6 11 6 6 6 7 7
6 14 6 6 6 8 2 6 12 12 6 2 2 2 2 2 2 11 11 7
6 6 14 6 15 6 2 6 12 6 15 2 6 10 10 6 2 6 11 7
6 6 15 6 6 6 2 8 6 6 8 2 6 6 10 6 2 6 11 7
6 6 15 8 15 6 2 6 15 15 8 2 14 9 9 6 2 14 11 7
6 13 2 2 2 2 2 6 6 6 8 2 6 15 9 6 2 6 7 7
13 13 2 14 6 6 14 6 7 6 6 2 6 9 10 6 2 6 7 7
13 13 2 6 6 11 6 7 7 6 14 2 14 9 10 6 2 6 6 6
13 13 2 6 6 11 7 7 7 6 6 2 6 9 10 6 2 8 6 15
13 13 2 6 15 11 7 7 7 11 11 2 6 9 10 14 2 6 15 6
13 6 2 6 6 11 11 6 12 6 11 2 6 9 6 6 2 6 6 6
13 6 2 2 2 2 2 6 6 6 6 2 6 9 9 6 2 6 14 6
6 6 6 14 8 6 2 2 2 2 2 2 6 6 9 6 2 2 2 23
6 6 12 6 15 6 6 12 12 6 14 6 12 6 8 6 15 6 6 6
