0 12
17 6 9 15 16 6 9 6 10 6 10 6 17 6 9 6 10 10 10 10
6 11 6 13 14 8 6 10 6 9 17 8 9 6 17 17 6 6 6 10
6 12 2 0 0 0 0 0 0 0 0 0 0 0 1 6 6 15 16 6
6 7 4 6 10 8 6 7 6 8 6 6 8 8 4 9 9 13 14 6
17 10 4 6 6 10 6 10 6 10 6 11 6 8 4 6 6 9 6 17
6 6 4 6 7 6 8 6 6 7 6 12 6 6 4 8 6 6 10 6
6 10 3 0 0 0 0 0 1 6 10 6 8 6 3 0 0 1 6 9
17 6 17 9 6 6 7 6 4 17 8 6 10 6 6 6 8 4 17 6
6 9 6 10 17 9 10 6 4 17 7 8 2 0 0 0 0 5 6 6
6 6 8 6 6 6 10 7 4 6 6 7 4 6 11 17 9 6 10 6
6 15 16 6 17 6 17 6 4 8 8 6 4 8 12 6 9 6 6 6
6 13 14 10 6 6 6 7 4 6 6 17 4 6 8 6 8 9 9 6
22 0 0 0 0 0 0 0 5 6 7 6 3 0 0 0 0 0 0 23
9 6 9 8 17 17 9 6 6 8 10 10 17 6 8 6 10 7 10 6
6 9 8 6 10 6 6 6 10 6 17 17 6 10 6 6 6 7 6 6
