0 7
15 9 9 15 14 15 14 17 15 17 14 16 16 10 6 6 6 6 7 14
10 6 6 7 16 14 15 16 16 17 16 14 17 10 6 6 6 6 6 17
17 8 6 6 0 0 0 0 0 0 17 17 15 17 12 12 8 6 12 15
14 15 8 6 0 10 6 6 11 0 16 9 9 9 0 0 0 0 14 14
17 14 16 15 0 10 6 12 17 0 10 6 6 6 0 14 15 0 16 17
16 14 14 15 0 10 6 7 9 0 16 8 6 6 0 17 16 0 17 16
17 15 17 16 0 10 6 6 6 0 14 17 12 12 0 16 14 0 15 16
22 0 0 0 0 17 12 8 6 0 17 14 16 17 0 17 15 0 14 16
17 14 15 14 15 17 14 10 6 0 17 16 9 16 0 14 17 0 16 14
14 17 15 17 14 14 15 16 17 0 16 10 6 11 0 17 14 0 0 23
17 9 9 9 0 0 0 0 0 0 17 9 6 11 0 9 9 9 6 11
10 6 6 6 0 17 14 16 17 17 14 6 6 11 0 6 6 6 6 11
10 6 12 12 0 16 17 14 17 14 16 12 12 17 0 6 11 12 12 14
15 16 17 15 0 0 0 0 0 0 0 0 0 0 0 12 15 17 14 15
17 15 15 16 17 17 10 6 6 6 11 17 15 14 17 14 17 14 17 14
